{
 "name": "Level 1",
 "tileMap": {
  "f": 106, "s": -1, "w": 129, "w1":127, "w2":130, "w3":131, "c": 150, "c1": 108, "c2": 109, "h": -2, " ": -1, "p": -1, "+": -1, "o": -1, "l": -1, "x": -1
 },
 "map": [
  [
   "c1", "c", "c", "c", "c", "c", "c", "c", "c", "c", "c", "c", "c", "c", "c", "c", "c", "c", "c", "c", "c", "c", "c", "c", "c", "c", "c", "c", "c", "c", "c", "c", "c", "c","c", "c2"
  ],
  [
   "w", " ", " ", " ", " ", " ", " ", " ", " ", " ", " ", " ", " ", " ", " ", " ", " ", " ", " ", " ", " ", " ", " ", " ", " ", " ", " ", " ", " ", " ", " ", " ", " ", " ", " ", "w1"
  ],
  [
   "w", " ", " ", " ", " ", " ", " ", " ", " ", " ", " ", " ", " ", " ", " ", " ", " ", " ", " ", " ", " ", " ", " ", " ", " ", " ", " ", " ", " ", "p", " ", " ", " ", " ", " ", "w1"
  ],
  [
   "w", " ", " ", " ", " ", " ", " ", " ", " ", " ", " ", " ", " ", " ", " ", " ", " ", " ", " ", " ", " ", " ", " ", " ", " ", " ", "l", " ", " ", " ", " ", " ", " ", " ", " ", "w1"
  ],
  [
   "w", " ", " ", " ", " ", " ", " ", " ", " ", " ", " ", " ", " ", " ", " ", " ", " ", " ", " ", " ", " ", " ", " ", " ", " ", " ", "f", "+", " ", " ", " ", " ", "+", " ", " ", "w1"
  ],
  [
   "w", " ", " ", " ", " ", " ", " ", " ", " ", " ", " ", " ", " ", " ", " ", " ", " ", " ", " ", " ", " ", " ", " ", " ", " ", "f", " ", " ", " ", " ", " ", " ", " ", " ", " ", "w1"
  ],
  [
   "w", " ", " ", " ", " ", " ", " ", " ", " ", " ", " ", " ", " ", " ", " ", " ", " ", " ", " ", " ", " ", " ", " ", " ", "f", " ", " ", " ", " ", " ", " ", " ", " ", " ", " ", "w1"
  ],
  [
   "w", " ", " ", " ", " ", " ", " ", " ", " ", " ", " ", " ", " ", " ", " ", " ", " ", " ", " ", " ", " ", " ", " ", "f", " ", " ", " ", " ", " ", " ", " ", " ", " ", " ", " ", "w1"
  ],
  [
   "w", " ", " ", " ", " ", " ", " ", " ", " ", " ", " ", " ", " ", " ", "o", " ", " ", " ", " ", " ", " ", " ", "f", " ", " ", " ", " ", " ", " ", " ", " ", " ", " ", " ", " ", "w1"
  ],
  [
   "w", "s", " ", " ", " ", " ", " ", " ", " ", " ", " ", " ", " ", " ", " ", " ", " ", "h", " ", " ", "f", " ", " ", " ", " ", " ", " ", " ", " ", " ", " ", " ", " ", " ", "x", "w1"
  ],
  [
   "w2", "f", "f", "f", "f", "f", "f", "f", "f", "f", "f", "f", "f", "f", "f", "f", "f", "f", "f", "f", "f", "f", "f", "f", "f", "f", "f", "f", "f", "f", "f", "f", "f", "f", "f","w3"
  ]
 ]
}
